._____________________.
|.....................|
|.....HH.......HH.....|
|.....HH.......HH.....|
|.....HH.......HH.....|
|.....HHHHHHHHHHH.....|
|.....HH.......HH.....|
|.....HH.......HH.....|
|.....HH.......HH.....|
|.....................|
|_____________________|