._____________________.
|.....................|
|......CCCCCCCC.......|
|....CCCC.....CCC.....|
|...CCC...............|
|..CCC................|
|...CCC...............|
|....CCCC.....CCC.....|
|......CCCCCCCC.......|
|.....................|
|_____________________|
