@@@@@@@@@@@@@@@@@@@@@@
@@@@@@@@@@@@@@@@@@@@@@
@@@@@@@@ /\_/\@@@@@@@@
@@@@@@@@( o.o )@@@@@@@
@@@@@@@@ > - < @@@@@@@     
@@@@@@@@@@@@@@@@@@@@@@
@@@@@@@@@@@@@@@@@@@@@@